1111111111     11
11 CB        A
1             F11
1     1  2      1
   F    C       1
  1   E    B   11
1     1D1      11
11 11  D1       1
11 1111 111111111
