1111111111     11
11  C   B    A
1    D     2   11
1   D 1         1
        C       1
 A1        B   11
1     1 1      11
11 11   1       1
11 1111 111111111
