1111111111     11
11  C   B       A
1    A1    2   11
1   A 1   C     1
      1         1
 A1      B B   11
1     1 1      11
11 11 A 1  A    1
11 1111A111111111
