1111111111     11
11  C   B    A
1              11
1     1         1
        C       1
 A1   E    B   11
1     1 1D     11
11 11   1 DB    1
11 1111 111111111
