1111111111     11
11  C   B    A
1          2   11
1     1         1
        C    B  1
 A1   E    B   11
1     1 1      11
11 11   1    E  1
11 1111 111111111
