1111111111     11
11              A
1    A1        11
1   A 1         1
      1    2    1
 A1            11
1     1 1      11
11 11 A 1       1
11 1111A111111111
